NO ./assets/textures/north.xpm
SO ./assets/textures/south.xpm
WE ./assets/textures/west.xpm
EA ./assets/textures/east.xpm
C 135,206,235
F 139,69,19

11111111111111111111111111
10000000000010000000000001
10111111111010111111111001
10100000001010100000001001
10101111101010101111101001
10101000101000101000101001
10101011101111101110111001
10001010001000001010000001
11111010111011111011101111
10000010100010000000101001
10111110101110111110101101
10000000100010000000100001
11101111111101111111111111
10001000000000000000100001
10101101111111111011011101
10100001000010000001000101
10111111011110111111011101
100000000100000000000000N1
11111111111111111111111111
