NO ./assets/textures/north.xpm
SO ../textures/south.xpm
WE ../textures/west.xpm
EA ../textures/east.xpm
C 135,206,235
F 139,69,19

1111111111111111111111111111111111
1000100000000000000000000000000001
10N0100000000000000000000000000001
1000100000000000000000000000000001
1000100000000000000000000000000001
1000100000000000000000000000000001
1000100001111100000000000000000001
1000100001000100000000000000000001
1000100001010100000000000000000001
1000100000010111111111111111111111
1000100000010000000000000000000001
1000111111111111111111111111111101
1000000000000000000000000000000001
1111111111111111111111111111111111
