NO ./assets/textures/north.xpm
SO ./assets/textures/south.xpm
WE ./assets/textures/west.xpm
EA ./assets/textures/east.xpm
C 135,206,235
F 139,69,19

11111111111111111111111111111
10000000N00000000000000000001
11111111111111111111111111101
10000000000000000000000000001
10111111111111111111111111111
10111111111111111111111111111
10111111111111111111111111111
10111111111111111111111111111
10111111111111111111111111111
10000000000000000000111111111
11111111111101111111111111111
11111111111101111111111111111
11111111110000011111111111111
11111111110010011111111111111
11111111110010011111111111111
11111111110000011111111111111
11111111111101111111111111111
11111111111100000000000000001
11111111111111111111111110111
11111111111111111111111110111
11111111111111111111111110111
11111111111111111111111110111
11111111111111111111111110111
10000000000000000000000000001
11111011110111110110101010111
11111011110111110110101010111
11111011110111110110101010111
11111011110111110110101010111
11111011111111011111111110111
11111011011111011111111110111
11111011011111000010001111111
11100000011111111111111111111
11100110011111111111111111111
11100000011111111111000111111
11111101111111111111010111111
11111101111110000000010111111
11111101111111111111010111111
11111100000000000000011111111
11111101111111111111111111111
11111111111111111111111111111