NO ./assets/textures/north.xpm
SO ./assets/textures/south.xpm
WE ./assets/textures/west.xpm
EA ./assets/textures/east.xpm
C 135,206,235
F 139,69,19

111111111111111111111111111111111111111111
100000000000000000111100000000000000000001
101111111111110000101100111111111111110001
101000000000010000101000100000000000010001
101011111110011110101011101111111110010001
101010000010000010001000001000000010010001
101010111010111011111011101011111010010001
101010101010100010000010001010001010010001
101010101010111110111110111010101010010001
101010101010000000100000000010101010010001
101011101011111110101111111110101110010001
101000001000000010101000000000100000010001
101111101111110010101011111111111110010001
100000101000010010101000000000000010000001
111110101011010010101011111111110011111101
100000101000010000100000000000010000000001
101111101111111111111111111110011111111101
101000001000000000000N00000010000000000001
101011111011111111111011111010111111110001
101010000010000010001010001010100000010001
101010111110111010101010101010111110010001
101010100000101010101010101000000010010001
101010101111101010111010101111110010010001
101010100000001010001010001000000010010001
101011111111101011101011111011111110010001
101000000000001000001000000010000000010001
101111111111111110111111111110111111110001
100000000000000000100000000000100000000001
111111111111101111101011111110101111111101
100000000001101000001010000010100000000001
101111111101101011111011111010111111110001
101000000101001010000010000010100000010001
101011110101111010111110111110101111010001
101000010100000010100000000000100001010001
101110010111111110101111111111111001110001
100010010100000000100000000000000100010001
111010010101111111111011111111111010010111
100010000100000000001000000000000010000001
101111111111111111101111111111111111111101
100000000000000000001000000000000000000001
111111111111111111111111111111111111111111
